Kenali Bahasa Gaul di Dunia Narkoba
Bahasa gaul adalah bahasa tak formal yang sering digunakan kelompok-kelompok pengguna. Memang istilah ini tidaklah menetap seperti bahasa formal dan akan berkembang sesuai dengan perkembangan. Namun tak ada salahnya, kita mengenal dunia mereka sehingga kita bisa membantu mereka penanggulangan masalah narkoba.

	Acid: nama lain LSD atau lysergic acid diethylamide
	Badog: jumlah pemakaian yang banyak dalam sekali penggunaan
	Badai: rasa melayang karena putau
	Barang: kata pengganti untuk obat
	BD: bandar
	Boat: Obat
	Bong: botol air dari plastik yang dilubangi dindingnya dan dimasukkan sedotan plastik
	Butterfly: jenis ekstasi
	Cekak, Ci: satuan jumlah morfin
	Cimeng: ganja
	Cucau: menyuntikkan heroin
	Dum: Dumolid, merek obat tidur
	Etep: putau
	Fly: mabuk
	Gap: tertangkap
	Gau: satuan putau
	Gelek: ganja
	Getrek: aparat polisi
	Giting: mabuk
	High: rasa senang saat mabuk
	Inex: jenis ekstasi
	Jackpot: muntah
	Kentang: kena tanggung
	Kondom: konci dompet
	Linting: satuan ganja yang dirokokkan
	Ngedrag: menghirip asap heroin yang dibakar
	Ngive: menyuntik zat ke pembuluh darah
	Nyipet: menggunakan putau dengan disuntik
	Pakau: pakai putau
	Parno: sedang menggunakan sabu-sabu
	Pil gedek: ekstaksi
	PT: putau
	Putau: jenis heroin
	Sakau: sakit karena putau
	STP: stok putau
	Toke: memakai ganja
	TU: hutang pada bandar
	Ubas: sabu-sabu
	Wakap: pakau
	Wakas: sakau

Disarikan dari Joweana S, Gangguan Mental dan Perilaku Akibat Penggunaan Zat Psikoaktif, Edisi 2. EGC: Jakarta. 2005.